{
    "#": 0,
    "\n": 1,
    " ": 2,
    "،": 3,
    "؛": 4,
    "؟": 5,
    "ء": 6,
    "ا": 7,
    "ب": 8,
    "ت": 9,
    "ث": 10,
    "ج": 11,
    "ح": 12,
    "خ": 13,
    "د": 14,
    "ذ": 15,
    "ر": 16,
    "ز": 17,
    "س": 18,
    "ش": 19,
    "ص": 20,
    "ض": 21,
    "ط": 22,
    "ظ": 23,
    "ع": 24,
    "غ": 25,
    "ف": 26,
    "ق": 27,
    "ك": 28,
    "ل": 29,
    "م": 30,
    "ن": 31,
    "ه": 32,
    "و": 33,
    "ي": 34
}